HABILIMENTS	HH AH B IH L AH M AH N T S
SIGNALIZE	S IH G N AH L AY Z
GAMBOLS	G AE M B AH L Z
ADOWN	AH D AW N
DISPOSERS	D IH S P OW Z ER Z
CLASPS	K L AE S P S
FINALLEST	F AY N AH L AH S T
TIPPLER	T IH P AH L ER
WHOSO	W AA S OW
HIMMALEH	HH IH M AH L
UNROLL	AH N R OW L
ELIGIBLY	EH L IH JH AH B L IY
ESPIES	EH S AY Z
CENOTAPH	S EH N AH T AH F
APPAL	AE P AH L
HADST	HH AE D S T
SEATJUST	S IY T JH AH S T
ENFOLDS	EH N F OW L D Z
ATTIRETH	AH T AY ER IH TH
KNOWEST	N OW AH S T
CLOVERS	K L OW V ER Z
QUICKLIKE	K W IH K L AY K
TERN	T ER N Z
WHIST	W IH S T
ASHINE	AH SH AY N
COMPASSED	K AH M P AH S T
INHERITORS	IH N HH EH R AH T ER Z
BLASPHEME	B L AE S F IY M
WORTHLESSNESS	W ER TH L AH S N AH S
ANEMONES	AE N AH M OW N Z
INANITION	AH N AH N IH SH AH N
MORTALITYS	M AO R T AE L AH T IY Z
TAMBORIN	T AE M B AH R AH N
MAJESTIES	M AE JH AH S T IY Z
PRATE	P R EY T
GIBRALTARS	JH IH B R AE L T AH R Z
STUPENDOUSNESS	S T UH P EH N D AH S N AH S
DISTINCTNESS	D IH S T IH NG K T N AH S
NULLS	N AH L Z
DIMNESS	D IH M N AH S
WHIMPERS	W IH M P ER Z
HOMELIER	HH OW M L IY ER
STREWS	S T R UW Z
VERDURE	V ER JH ER
BESETS	B IH S EH T S
SOEVER	S OW AH V AH R
SINEW	S IH N Y UW
SOBERER	S OW B ER ER
OERTAKELESS	AH R T EY K L AH S
INCAUTIOUS	IH N K AO SH AH S
QUIBBLED	K W IH B AH L D
UNCONSPICUOUS	AH N K AH N S P IH K Y AH W AH S
UNLADEN	AH N L EY D AH N
NIGHTGOWNS	N AY T G AW N Z
MERCURYS	M ER K Y AH R IY Z
WITHHOLDEN	W IH TH HH OW L D AH N
CHIMBORAZO	CH IH M B AO R AH Z OW
PIERCES	P IH ER S IH Z
ANNEALED	AE N IY L D
CAJOLES	K AH JH OW L Z
UNBRAIDING	AH N B R EY D IH NG
GRIMED	G R AY M D
BRIDALLED	B R AY D AH L D
TRILLED	T R IH L D
CRASHS	K R AE SH S
FAMES	F EY M Z
FRESHET	F R EH SH AH T
QUAINTEST	K W EY N T AH S T
UNPRETENDING	AH N P R IY T EH N D IH NG
DISPARAGEMENT	D IH S P AE R IH JH M AH N T
SOMEBODYS	S AH M B AA D IY Z
OBLOQUY	AA B L OW K W IY
THESSALY	DH AH Z AH L IY
POPOCATAPEL	P AA P AH K AE T AH P AH L
CHRYSOLITE	K R IH S AH L AY T
KIDDERMINSTER	K IH D AH R M IH N S T AH R
UNVISITED	AH N V IH Z AH T IH D
TWOULD	T W OW L D
TALELESS	T EY L AH S
FAMISH	F EY M IH SH
MARSHALLINGS	M AA R SH AH L IH NG Z
GREEDINESS	G R IY D IY N AH S
BRIGAND	B R IH G AH N D
DEFACES	D IY F EY S IH Z
CASEMENT	K EY S M AH N T
DECALOGUE	D AH K AE L AH G
MISGIVES	M IH S G IH V Z
OBLOQUIES	AA B L AA K W AY Z
HALLOWING	HH AE L OW IH NG
WOULDST	W OW L D S T
GIRLHOODS	G ER L HH UH D Z
EXTENTS	EH K S T EH N T S
SELDOMLY	S EH L D AH M L IY
PROFANED	P R OW F EY N D
EPAULETTED	EH P AH L EH T IH D
DEMOSTHENES	D AH M AA S TH IY N Z
RITARDANDO	R IH T AH R D AE N D OW
MATURER	M AH T Y UH R ER
DIMITY	D AY M AH T IY
PAIDST	P EY D S T
CORINTHIANS	K OW R IH N TH IY AH N Z
SMOULDERING	S M OW L D IY R AH NG
PRITHEE	P R AY TH IY
ENCHANTS	EH N CH AE N T S
ASELF	AH S EH L F
BEFALLING	B IH F AO L IH NG
AUGUSTAN	AH G AH S T AH N
FRINGED	F R IH N JH D
INDIAMAN	IH N D IY AH M AE N
CONTENTETH	K AH N T EH N T IH TH
SHREWDER	SH R UW D ER
FATHOMED	F AE DH AH M D
KNEELS	N IY L Z
HYBLA	HH IH B L AH
TINTING	T IH N T IH NG
DIMINUET	D AH M IH N Y UW AH T
EXHILARATES	IH G Z IH L ER AH T S
PRACTISING	P R AE K T AH S IH NG
CREDIBILITYS	K R EH D AH B IH L AH T IY Z
WHIR	W ER
PATIENTEST	P EY SH AH N T AH S T
GLADDENED	G L AE D AH N D
STRANGERD	S T R AE N JH AH R D
BONNETS	B AA N AH T S
CONJECTURED	K AH N JH EH K CH ER D
SUFFICETH	S AH F AY S IH TH
FOXGLOVES	F AA K S G L AH V Z
WAYLAYING	W EY L EY IH NG
SWAGGERS	S W AE G ER Z
EXPENDS	IH K S P EH N D Z
PRICKLIER	P R IH K L IY ER
ABETS	AH B EH T S
NOTCHING	N AA CH IH NG
APOSTACY	AH P OW S T AH S IY
RECEIPTED	R IH S IY T IH D
SPRIG	S P R IH G
UNDECAYING	AH N D IH K EY IH NG
IMPERATOR	IH M P ER EY T ER
DUNCE	D AH N S
SOLEMNEST	S AA L AH M AH S T
JESSAMINES	JH EH S AH M AY N Z
COCHINEAL	K OW CH AY N AH L
WAST	W AA S T
RHODORAS	R AA D AH R AH Z
TAMARIND	T AE M AH R AY N D
ANGLEWORM	AE NG G AH L W ER M
BETROTHED	B IH T R AO TH T
RENOVATES	R EH N AH V EY T S
BETHOUGHT	B IH TH AO T
LIKEST	L AY K AH S T
ENTHRALL	IH N TH R AE L
WHERESOEER	W EH R AH S OW IH R
LATHED	L EY DH D
OPAQUEST	OW P EY K AH S T
GRIEFS	G R IY F S
HADNT	HH AE D N T
COURSERS	K OW R S ER Z
CUIRASS	K UW R AH S
BEGONE	B IH G AO N
EXULTATION	EH K S AH L T EY SH AH N
UNCONJECTURED	AH N K AH N JH EH K CH ER D
HEADLANDS	HH EH D L AE N D Z
RAVISHED	R EY V IH SH T
BARDS	B AA R D Z
BROODS	B R UW D Z
SHAGGIER	SH AE G IY ER
MITRED	M AY T ER D
ADAMANTINE	AH D AE M AH N T AY N
GRAPHICKER	G R AE F IH K S ER
CAPUCHIN	K AE P AH CH AH N
GABRIELS	G AE B R IY L Z
KNOWST	N OW S T
JEHOVAHS	JH EH HH AH V AH Z
AMBUSCADE	AE M B AH S K EY D
JUSTEST	JH AH S T AH S T
SALUBRIOUS	S AH L UW B R IY AH S
DECALOGUES	D AH K AE L AH G Z
AFFIANCE	AH F AY AH N S
ENCOMIUM	EH N K OW M IY AH M
MASHES	M AE SH IH Z
STATELIER	S T EY T L IY ER
MATINS	M AE T AH N Z
INDORSEMENT	IH N D AO R S M AH N T
TRANQUILLER	T R AE NG K W AH L ER
CORRODELESS	K AH R OW D L AH S
HERSCHELS	HH AH R S AH L Z
UNHOOKED	AH N HH UH K T
SIROCCOS	S AH R AA K AH Z
FAILEST	F EY L AH S T
OBLIQUITY	OW B L IY K AH T IY
MARSHALLING	M AA R SH AH L IH NG
EIDER	IY D AH R
DISSOLUTE	D IH S AA L Y UW T
ADZE	AE D Z
NEIGHS	N EY Z
DUSKER	D AH S K ER
LISPS	L IH S P S
JOGGLING	JH AA G L AH NG
BEHEADS	B IH HH EH D Z
CONSOLELESSLY	K AH N S OW L AH S L IY
SUPREMEST	S UH P R IY M AH S T
STAMMERED	S T AE M ER D
LEONTODON	L IY AA N T AH D AH N
INTERROGATES	IH N T EH R AH G EY T S
REPEALLESS	R IH P IY L AH S
ETIQUETTES	EH T IH K AH T S
TRAVERSES	T R AE V ER S IH Z
SUSCEPTIVE	S AH S EH P T IH V
DEITYS	D IY AH T IY Z
LOWLIER	L OW L IY ER
SCANTEST	S K AE N T AH S T
PLASHING	P L AE SH AH NG
ABODES	AH B OW D Z
REPOSED	R IY P OW Z D
REPRIEVES	R IH P R IY V Z
HAIRBREADTH	HH EH R B R EH D TH
ATROPOS	AE T R AH P AH Z
OUTVISIONS	AW T V IH ZH AH N Z
SEVRES	S EH V AH R Z
RECORDLESS	R IH K AO R D L AH S
STEALTHS	S T EH L TH S
MANTELS	M AE N T AH L Z
UNTRAVELLED	AH N T R AE V AH L D
ENDOWAL	EH N D AW AH L
IRN	AH R N
AILED	EY L D
BLESSEDER	B L EH S T ER
NAYNATURE	N EY N EY T Y AH R
DROWSE	D R AW Z
PLASHLESS	P L AE SH L AH S
ABSTEMIOUSLY	AE B S T AH M IY OW AH S L IY
TOILETTE	T OY L EH T
BATIZE	B EY T AY Z
RIME	R AY M
115	W AH N W AH N F AY V
DEPOSES	D IY P OW Z IH Z
DISARMS	D IH S AA R M Z
TERRENE	T EH R IY N
STOPLESS	S T AA P L AH S
FEDERATES	F EH D ER AH T S
DEMURRAL	D IH M ER AH L
CIRCASSIAN	S AH R K AE S IY AH N
BOSPORUS	B AA S AH R AH S
FARTHINGS	F AA R TH IH NG Z
DOLLIES	D AA L IY Z
EXACTNESS	IH G Z AE K T N AH S
HARANGUER	HH AH R AE NG ER
INTERPOSED	IH N T ER P OW Z D
SWERVELESS	S W ER V L AH S
SUNDERED	S AH N D ER D
SALLOW	S AE L OW
REAPERS	R IY P ER Z
DELLS	D EH L Z
CONTEMN	K AA N T EH M
FELLOWMEN	F EH L OW M EH N
POINARDS	P OY N AH R D Z
SCUTCHEOP	S K AH CH IY AH P
NOWS	N AW Z
PROFOUNDER	P R OW F AW N D ER
LEANETH	L IY N IH TH
EXTEMPORIZING	IH K S T EH M P AH R AY Z IH NG
IE	AY
BOUNTEOUS	B AW N T IY AH S
SOVEREIGNTIES	S AA V R AH N T IY Z
INDIGENCE	IH N D IH JH AH N S
MUTENESS	M Y UW T N AH S
BESTOWAL	B IH S T OW AH L
UNBEREFT	AH N B IH R EH F T
CAPERED	K EY P ER D
MALIGNITY	M AH L AY N AH T IY
JOCUND	JH AA K AH N D
EXCELLENTER	EH K S AH L AH N T ER
HOUSEWIFES	HH AW S W AY F S
ELIJAHS	EH L AH JH AH Z
DESCRY	D EH S R IY
RAVELLED	R AE V AH L D
THERELL	TH EH R AH L
PANGLESS	P AE NG L AH S
BREADTHS	B R EH D TH S
YOURE	Y OW Y AH R
LONELIER	L OW N L IY ER
MYRRHS	M ER Z
NEIGHING	N EY AH NG
PLASH	P L AE SH
FORSAKES	F AO R S EY K S
MAKETH	M EY K IH TH
PROPITIATE	P R OW P IH SH IY AH T
CHILLEST	CH IH L AH S T
NICODERNUS	N IH K AH D AH R N AH S
AUTUMNS	AO T AH M Z
BREAKFASTED	B R EH K F AH S T IH D
EXORCISED	EH K S AO R S AY Z D
SHOWETH	SH OW IH TH
BEHOLDS	B IH HH OW L D Z
BOBADILO	B AH B AE D AH L OW
JOTS	JH AA T S
CHORISTER	CH OW R IY S T ER
ATMOSPHERES	AE T M AH S F IH ER Z
THEYRE	TH EY R
COGS	K AA G Z
STEPT	S T EH P T
FIFES	F AY F S
CURTNESS	K ER T N AH S
RESTITUTES	R IH S T IH T Y UW T S
NUMIDIAN	N Y UW M IH D IY AH N
RESURRECTIONS	R EH Z AH R EH K SH AH N Z
ORCHIS	AO R CH AH S
PERFECTER	P ER F AH K T ER
STEALTHILY	S T EH L TH IY L IY
MEEKEST	M IY K AH S T
UNGRACIOUS	AH N G R EY SH AH S
BETIMES	B IH T AY M Z
SHRIVELLED	SH R IH V AH L D
ABLOSSOM	AH B L AA S AH M
BURS	B AH R Z
ASTIR	AH S T ER
PRESENTIMENT	P R IY S EH N T AH M AH N T
FLITS	F L IH T S
HAPLY	HH AE P L IY
BEAREST	B AE ER AH S T
TWASNT	T W AA Z N T
WORTHILY	W ER DH IY L IY
DECOYED	D IY K OY D
UNREMEMBERED	AH N R IH M EH M B ER D
NOUGHT	N AO T
SOS	EH OW EH S
EFFACES	IH F EY S IH Z
ATTAINMENTS	AH T EY N M AH N T S
PHIALS	F AY AH L Z
CORPOREAL	K AO R P OW R IY AH L
EFFACED	IH F EY S T
BOBOLINK	B AA B AH L AH NG K
PIERLESS	P IH ER L AH S
BIRDLING	B ER D L IH NG
ASTONISHES	AH S T AA N IH SH IH Z
MADDEST	M AE D AH S T
CORKLESS	K AO R K L AH S
WHOVE	W OW V
UNVARYING	AH N V EH R IY IH NG
TWIXT	T W IH K S T
INVINCIBLY	IH N V IH N S AH B AH L IY
MIDNIGHTS	M IH D N AY T S
AFFLICTIVE	AH F L IH K T IH V
FLAMBEAUX	F L AE M B IY AH K S
MEAGRE	M IY G AH R
UNHELPED	AH N HH EH L P T
PSALTERIES	S AE L T AH R AY Z
HOMELIEST	HH OW M L IY AH S T
UNSUSPENDED	AH N S AH S P EH N D IH D
CURELESS	K Y UH R L AH S
SLINK	S L IH NG K
EXTREMEST	IH K S T R IY M AH S T
CORONAL	K ER OW N AH L
TRUFFLED	T R AH F AH L D
DAPPLED	D AE P AH L D
UNFREQUENTED	AH N F R IY K W AH N T IH D
CINDERELLAS	S IH N D AH R EH L AH Z
BURDOCKS	B AH R D AH K S
WHETS	W EH T S
BUTTERFLYS	B AH T ER F L AY Z
CYPHERER	S AH F IY R AH R
RIPENINGS	R AY P AH N IH NG Z
UNSANCTIFIED	AH N S AE NG K T AH F AY D
ACCOSTS	AH K AO S T S
UNANSWERING	AH N AE N S ER IH NG
RETRIEVELESS	R IH T R IY V L AH S
DOTES	D OW T S
AUSPICIOUSLY	AO S P IH SH AH S L IY
TENERIFFE	T EH N AH R AH F
PHANTASMS	F AE N T AH Z AH M Z
UNTWIST	AH N T W IH S T
NOTEXPLAINED	N AA T AH K S L EY N D
ADHESIONS	AE D HH IY ZH AH N Z
GAMBOLLED	G AE M B AH L D
AMPLEST	AE M P AH L AH S T
LISPING	L IH S P IH NG
TURBID	T AH R B AH D
WEIGHETH	W EY IH TH
SEEKETH	S IY K IH TH
GOURMAND	G AH R M AH N D
ITALICIZE	AY T AE L AH S AY Z
RETRIMMED	R IY T R IH M D
DEFORMING	D IY F AO R M IH NG
SINGETH	S IH N JH IH TH
SPOOLS	S P UW L Z
COSMOPOLITES	K AA S M AA P AH L AY T S
ESTRANGING	IH S T R EY N JH IH NG
DROUGHTLESS	D R AW T L AH S
COEVAL	K OW IY V AH L
TILINGS	T AY L IH NG Z
VEGETATIONS	V EH JH AH T EY SH AH N Z
HEMLOCKS	HH EH M L AA K S
NOISELESS	N OY Z L AH S
HIMSELFLIKE	HH IH M S EH L F L AY K
IMPORTUNITY	IH M P ER T UW N AH T IY
WHEREFORE	W EH ER F OW R
SLAKE	S L EY K
VOUCHES	V AW CH IH Z
TARRIED	T AE R IY D
SPECTRAL	S P EH K T R AH L
HERES	HH IH ER Z
SAPPHO	S AE P OW
AVOWING	AH V AW IH NG
UNOBSERVED	AH N AH B Z ER V D
RUSSETLY	R AH S AH T L IY
HERMETIC	HH ER M EH T IH K
HUMMED	HH AH M D
SCAPING	S K EY P IH NG
MERRIMENT	M EH R IY M AH N T
CONCISEST	K AH N S AY S AH S T
RAVELLING	R AE V AH L IH NG
REMAINETH	R IH M EY N IH TH
DISENTHRALL	D IH S AH N TH R AE L
CRIERS	K R AY ER Z
UNDEPICTED	AH N D IH P IH K T IH D
CLEOPATRAS	K L IY AH P AE T R AH Z
THRUM	TH R AH M
THRO	TH R OW
SPIKENARDS	S P IH K AH N AH R D Z
DOMENICHINO	D AA M AH N IH CH AH N OW
MEMORE	M EH M AH R
AGGRANDIZED	AE G R AH N D AY Z D
CONSCIOUSER	K AA N SH AH S ER
PERCEIVELESS	P ER S IY V L AH S
WHITTLES	W IH T AH L Z
PERISHES	P EH R IH SH IH Z
FINITUDE	F AY N AH T UW D
REPAST	R IY P AE S T
ANNULS	AE N Y AH L Z
OBELISK	AA B AH L IH S K
RETROSPECTION	R EH T R AH S P EH K SH AH N
FORSWEARS	F AO R S W AE ER Z
DIVINEST	D AH V AY N AH S T
THENCEFORWARD	TH EH N S AH F AO R W AH R D
INTEMPERANCE	IH N T EH M P ER AH N S
MERCHANTMAN	M ER CH AH N T M AE N
DISSEMBLER	D IH S EH M B AH L ER
SANCTIFIES	S AE NG K T AH F AY Z
QUIVERS	K W IH V ER Z
FRILLED	F R IH L D
BRAVERIES	B R EY V AH R IY Z
PALLS	P AO L Z
SAITH	S EY TH
AUXILIARIES	AO G Z IH L Y AH R IY Z
OUTVIE	AW T V AY
MEMRY	M EH M R IY
REGALE	R IH G EY L
WHIRLS	W ER L Z
CHID	CH IH D
BANDITTI	B AE N D IH T IY
QUARTERING	K W AO R T ER IH NG
VERRIERE	V EH R IY R
TREMENDOUSNESS	T R IH M EH N D AH S N AH S
SUPREMER	S UH P R IY M ER
DRUIDIC	D R UW AH D IH K
SECURER	S IH K Y UH R ER
VIITAIITY	V IY T EY AH T IY
CAVIL	K AE V AH L
PROPITIATIONS	P R OW P IH SH IY EY SH AH N Z
SNAPT	S N AE P T
DUCATS	D Y UW K EY T S
CULPABLER	K AH L P AH B AH L AH R
PAUSELESS	P AO Z L AH S
HIDETH	HH AY D IH TH
UNBLUSHINGLY	AH N B L AH SH IH NG L IY
RECUSANCE	R EH K Y AH Z AH N S
PILATE	P AY L AH T
WAINSCOT	W EY N S K AA T
WAGGONS	W AE G AH N Z
CONTENTEDER	K AH N T EH N T EH D ER
FORCEMAY	F OW R S M EY
SAGACITY	S AA G AH S IH T IY
EXODY	IH G Z AA D IY
SUBSISTING	S AH B S IH S T IH NG
GARLANDS	G AA R L AH N D Z
HUNGR	HH AH N G R
BLANKETLESS	B L AE NG K AH T L AH S
INHERES	IH N HH IH ER Z
AFFECTINGLY	AH F EH K T IH NG L IY
PUTTETH	P AH T IH TH
NOWIT	N OW AH T
GOODMORROW	G UH D M AA R OW
SUSPENSES	S AH S P EH N S IH Z
IRRESOLUTE	IH R EH Z AH L UW T
WISENESS	W AY Z N AH S
CHIEFEST	CH IY F AH S T
SWANG	S W AA NG
DUSTIEST	D AH S T IY AH S T
TILLAGE	T IH L AE JH
ESCUTCHEON	IH S K AH CH AH N
AFORETIME	AH F OW R T AY M
THEYCOME	TH EY K OW M
SETTEST	S EH T AH S T
MEETST	M IY T S T
ADDINGS	AE D IH NG Z
TROTWOOD	T R AA T W UH D
EQUIPAGE	IH K W IH P IH JH
DROWSING	D R AW Z IH NG
DEVASTATES	D EH V AH S T EY T S
ASSIGNABLE	AH S AY N AH B AH L
SEPAL	S IY P AH L
DECEIVES	D IH S IY V Z
HERESIES	HH EH R AH S IY Z
TIMBUCTOO	T IH M B AH K T UW
CORDIALITY	K AO R JH AH L AH T IY
SUBJECTION	S AH B JH IH K SH AH N
UNREVEALED	AH N R IH V IY L D
DISHEVELS	D IH SH EH V AH L Z
POPULATES	P AA P Y AH L AH T S
PROMPTER	P R AA M P T ER
SHEWN	SH UW N
INHERE	IH N HH IH ER
PREAPPOINTED	P R IY AH P OY N T IH D
PUCKS	P AH K S
TRANSFIGURED	T R AE N S F IH G Y ER D
SUNBURNT	S AH N B ER N T
MEAGRES	M IY G AH R Z
LIKEALIVE	L AY K AH L IH V
INTERMIT	IH N T ER M IH T
EDIFICES	EH D AH F AH S IH Z
TIMIDNESS	T IH M AH D N AH S
TRANSMIGRATION	T R AE N S M AY G R EY SH AH N
GNASHED	N AE SH T
BUMBLEBEES	B AH M B AH L B IY Z
INHALES	IH N HH EY L Z
CLOVEN	K L OW V AH N
ENVIES	EH N V IY Z
TOTTERS	T AA T ER Z
BOBOLINKS	B AA B AH L AH NG K S
BETIDES	B IH T AY D Z
BARGEMEN	B AA R JH EH M AH N
SHOPMAN	SH AA P M AE N
REDIGNIFIED	R IY D IH G N AH F AY D
RETROSPECTS	R EH T R AH S P EH K T S
ARRAIGNS	AH R EY N Z
PERTURBLESS	P ER T ER B L AH S
GALLANTER	G AE L AH N T ER
PARASOLS	P AE R AH S AO L Z
SMITES	S M AY T S
FOURSCORE	F OW R S K OW R
PARTOOK	P AA R T UH K
UNSUMMONED	AH N S AH M AH N D
UNSHRIVENL	AH N SH R IH V AH N L
ARARATS	AE R AH R EY T S
PURLED	P ER L D
INLANDS	IH N L AH N D Z
OUTWITHIN	AW T W IH TH IH N
ARTLESS	AA R T L AH S
FLESHLY	F L EH SH L IY
UPBRAIDS	AH P B R EY D Z
VESUVIAN	V AH S UW V IY AH N
SORER	S OW R ER
PROMETHEUS	P R AH M IY TH IY AH S
MERCYS	M ER S IY Z
CYPHERLESS	S AH F EH R L AH S
DEADTHE	D IY AE D
WHATSOEER	W AA T S OW IH R
BLEMISHLESS	B L EH M IH SH L AH S
CURDLED	K ER D AH L D
DISTILS	D IH S T IH L Z
FAMELESS	F EY M L AH S
DYINGBUT	D AY IH N G AH T
BELSHAZZAR	B IH L SH AE Z AH R
REND	R EH N D
ENTOMBER	EH N T UW M ER
FAILLESS	F EY L AH S
AURORAN	AO R AH R AH N
VENOMS	V EH N AH M Z
THEREFROM	DH AE R F R AH M
INVALIDATES	IH N V AE L AH D EY T S
NEBO	N EH B OW
VESTMENTS	V EH S T M EH N T S
CONVERGES	K AH N V ER JH IH Z
WRETCH	R EH CH
SKILFUL	S K IH L F AH L
TENANTLESS	T EH N AH N T L AH S
GRATITUDES	G R AE T AH T UW D Z
MARAUDS	M AH R AO D Z
SPANGLES	S P AE NG G AH L Z
RASCALITY	R AE S K AH L AH T IY
CHANTICLEER	CH AE N T IH K L IH ER
MOCHAS	M OW K AH Z
BLEATING	B L IY T IH NG
SECRETING	S IH K R IY T IH NG
LATEL	L AE T AH L
GLUTTON	G L AH T AH N
DISAVOWS	D IH S AH V AW Z
CRUMBLESS	K R AH M L AH S
INFINITUDE	IH N F AY N AH T UW D
FIRMAMENTAL	F ER M AH M EH N T AH L
UNFADING	AH N F EY D IH NG
CRAVAT	K R AE V AH T
CHISELLED	CH IH Z AH L D
CALUMNIES	K AE L AH M N IY Z
SELECTLY	S AH L EH K T L IY
DISTAFF	D IH S T AE F
BETROTHAL	B IH T R AO TH AH L
ENFEEBLES	EH N F IY B AH L Z
HOOTING	HH UW T IH NG
COMPELLETH	K AH M P EH L IH TH
IMPS	IH M P S
PROGNOSTICS	P R AA G N AA S T IH K S
SATIETY	S AH T AY AH T IY
REJOICES	R IH JH OY S IH Z
REMOTER	R IY M OW T ER
ACUTER	AH K Y UW T ER
BADINAGE	B AE D AH N AA ZH
PERSPICACITY	P AH R S IH S AH S AH T IY
COMPETELESS	K AH M P IY T L AH S
SAGEST	S EY JH AH S T
DECLAIMING	D IY K L EY M IH NG
CHILDHOODSOME	CH AY L D HH UH D S AH M
PHRASELESS	F R EY Z L AH S
LITDE	L IH T D
ITLAST	IH T L AH S T
CALLETH	K AO L IH TH
SOREST	S OW R AH S T
BODILESS	B AA D IY L AH S
CHAPEAUX	CH EY P IY AH K S
VENDED	V EH N D IH D
HIST	HH IH S T
WESTS	W EH S T S
ISRAELS	IH Z R IY L Z
ANODYNE	AE N AH D AY N
MARROWLESS	M AE R OW L AH S
SUFFICING	S AH F AY S IH NG
SPLENDORS	S P L EH N D ER Z
TUN	T AH N
ENTHRALLING	IH N TH R AO L IH NG
UMBER	AH M B ER
CHIMNEYAND	CH IH M N EY AH N D
STOUTER	S T AW T ER
CRUCIFIXAL	K R UW S AH F IH K S AH L
SCANTLY	S K AE N T L IY
TOTALNESS	T OW T AH L N AH S
DEPUTED	D IY P UH T IH D
NOTELESS	N OW T L AH S
FAMILIARITIES	F AH M IH L Y AE R AH T IY Z
UNOBTAINED	AH N AH B T EY N D
FLAVORLESS	F L EY V ER L EH S
INFINITES	IH N F AH N AH T S
INFINITER	IH N F AH N AH T ER
GAIETY	G EY AH T IY
PROMPTNESS	P R AA M P T N AH S
LARGESTTHEN	L AA R JH AH S T TH AH N
MARL	M AA R L
REPINE	R IY P AY N
QUAILED	K W EY AH L D
PRACTISED	P R AE K T IH S T
SUPERFINE	S UW P ER F AY N
SUPERFICIES	S UW P AH R F AH S AY Z
BERNARDINE	B IH R N AA R D AY N
STALACTITE	S T AE L AH K T AY T
UNPRETENSION	AH N P R IY T EH N CH AH N
FOOTLESS	F UH T L AH S
SOLACED	S AA L AH S T
POMPLESS	P AA M P L AH S
RUSTICS	R AH S T IH K S
ECSTASYS	EH K S T AH S IY Z
HOSTILER	HH AA S T AH L ER
SOLACES	S AA L AH S IH Z
DIVINER	D AH V AY N ER
CODICIL	K OW D IH S AH L
PENTATEUCHAL	P EH N T EY T Y UW CH AH L
BEQUEATHS	B IH K W IY TH S
HAME	HH EY M
UNSHADED	AH N SH EY D IH D
CHAMOIS	SH AE M IY
PITTANCES	P IH T AH N S IH Z
IVE	AY V
PALLIATE	P AE L IY AH T
TRACKLESS	T R AE K L AH S
AUDIBLER	AO D AH B AH L ER
RAPTURES	R AE P CH ER Z
THRONES	TH R OW N Z
UNDORJE	AH N D AO R JH
MOULDERED	M OW L D ER D
DELUSIVE	D IY L AH S AH V
GROPES	G R OW P S
MOULDERING	M OW L D ER IH NG
TWOULDNT	T W OW L D N T
UNPERCEIVED	AH N P ER S IY V D
TUGSWITHIN	T AH G Z W IH TH IH N
DESPATCHED	D IH S P AE CH T
BITTERER	B IH T ER ER
MORE1	EH M OW AA R IY W AH N
ENGLANDLY	EH N G L AE N D L IY
ETNAS	EH T N AH Z
MULTIFOLD	M AH L T AY F OW L D
TREMBLINGLY	T R EH M B AH L IH NG L IY
UNTRAVERSED	AH N T R AE V ER S T
COMMONEST	K AA M AH N AH S T
GORSE	G AO R S
ILLUME	IH L UW M
CORNETS	K AA R N EH T S
FOUNDS	F AW N D Z
PARIAN	P AE R IY AH N
PASSIVER	P AE S IH V ER
DAUNTLESS	D AO N T L AH S
WOMANS	W UH M AH N Z
PLUMED	P L UW M D
ENDEARS	EH N D IH ER Z
BLEATS	B L IY T S
OFFENCE	AH F EH N S
PARTAKING	P AA R T EY K IH NG
CONVEXAND	K AA N V EH K S AH N D
ROBBERD	R AA B AH R D
POSSIBLER	P AA S AH B AH L ER
POSSIBLES	P AA S AH B AH L Z
THIRSTED	TH ER S T IH D
RUBYS	R UW B IY Z
UNERUDITE	AH N EH R Y AH D AY T
OUTSTARING	AW T S T EH R IH NG
SEVERER	S EH V IH R ER
INTRENCHED	IH N T R EH N CH T
WAYWARDEST	W EY W ER D AH S T
STRANGLES	S T R AE NG G AH L Z
FADELESS	F EY D L AH S
THROE	TH R OW
ASTERISKS	AE S T AH R IH S K S
TANKARDS	T AE NG K AH R D Z
POTOSI	P AA T AH S IY
PERUSER	P AH R UW Z ER
YOUVE	Y AW V
AMPHITRITE	AE M F AH T R AY T
ANOTHERS	AH N AH DH ER Z
YOUD	Y AW D
FRITTERS	F R IH T ER Z
ENCHANTLESS	EH N CH AE N T L AH S
STARLESS	S T AA R L AH S
ATTENDETH	AH T EH N D IH TH
HES	HH IY Z
CICATRICE	S AH K AE T R AH S
HED	HH IY D
INDORSED	IH N D AO R S T
POSTPONELESS	P OW S T P OW N L AH S
BARONIAL	B AH R OW N IY AH L
BETOKEN	B IH T OW K AH N
MAKST	M AE K S T
DOWERED	D AW ER D
PRECONCERTED	P R IY K AH N S ER T IH D
ARRESTLESS	AH R EH S T L AH S
TERMINUS	T ER M AH N AH S
JAMAICAS	JH AH M EY K AH Z
OPHIR	AA F AH R
SCORNING	S K AO R N IH NG
WEALTHILY	W EH L TH IY L IY
DECAMPING	D IY K AE M P IH NG
CONCEIVELESS	K AH N S IY V L AH S
BRYANTS	B R AY AH N T S
ETERNITIES	IH T ER N AH T IY Z
DEFENCES	D IY F EH N S IH Z
IMPALPABLE	IH M P AE L P AH B AH L
ABASHETH	AH B AE SH IH TH
UPLIFTS	AH P L IH F T S
BISECTED	B AY S EH K T IH D
SUBJUGATING	S AH B JH IH G EY T IH NG
HASNT	HH AE Z N T
LETHE	L EH DH
EBON	EH B AH N
THITHER	TH IH DH ER
TWERE	T W IH R
DIADEML	D AY AH D AH M L
CAROLLED	K AE R AH L D
PERADVENTURE	P ER AH D V EH N CH ER
DIADEMS	D AY AH D AH M Z
BERRYS	B EH R IY Z
APPARELED	AH P AE R AH L D
BEQUEATHING	B IH K W IY TH IH NG
MANBE	M AE N B IY
REPORTLESS	R IH P OW R T L AH S
NEIGH	N EY
BOSOMS	B UH Z AH M Z
DINNA	D IH N AH
BUILCFAS	B UW L K AH Z
GENTLEFOLK	JH EH N T AH L F OW K
ESPIED	EH S AY D
SLUNK	S L AH NG K
COCKADE	K AA K EY D
OWNEST	OW N AH S T
TRANQUILLITY	T R AE NG K W IH L IH T IY
UNFURNISHED	AH N F ER N IH SH T
UNMEANING	AH N M IY N IH NG
BESTIR	B IH S T ER
ANYBODYS	EH N IY B AA D IY Z
MECHLIN	M EH K L AH N
PERIHELION	P AH R AH HH IY L IY AH N
CUNNINGLY	K AH N IH NG L IY
REMEDILESSLY	R IY M IY D IY L AH S L IY
THOMSONS	TH AA M Z AH N Z
LACERATING	L AE S AH R EY T IH NG
CONTROVERTIBLE	K AA N T R AH V ER T AH B AH L
CONFEDERATES	K AH N F EH D ER AH T S
DUSKY	D AH S K IY
BECOMETH	B IH K AH M IH TH
DOWRIES	D AW R IY Z
ADROITER	AH D R OY T ER
SITUATES	S IH CH AH W EY T S
PLUMMETLESS	P L AH M AH T L AH S
MAYEST	M EY AH S T
BOHEA	B AA HH IY AH
RECALLLESS	R IY K AO L AH S
PORTENTOUSLY	P AO R T EH N T AH S L IY
DEATHLESSNESS	D EH TH L AH S N AH S
LIBATION	L AY B EY SH AH N
PROPOUNDETH	P R OW P AW N D IH TH
ANTEDATES	AE N T IH D AH T S
MINUETS	M IH N Y AH W EH T S
MAZARIN	M EY Z ER IH N
UNTARNISHED	AH N T AA R N IH SH T
CHRISTS	K R AY S T S
UNPUZZLED	AH N P AH Z AH L D
DILAPIDATIONS	D AH L AE P AH D EY SH AH N Z
BESTIRS	B IH S T ER Z
VESPERS	V EH S AH R Z
NOSEGAYS	N OW Z G EY Z
ESCAPELESS	IH S K EY P L AH S
PARTAKES	P AA R T EY K S
EXTREMER	IH K S T R IY M ER
TUSCARORA	T AH S AE R AH R AH
PARTAKEN	P AA R T EY K AH N
BRAVOES	B R AA V OW Z
SUPPLICATE	S AH P L AH K AH T
TRANQUILLY	T R AE NG K W AH L IY
TENDERER	T EH N D ER ER
TOTTERED	T AA T ER D
BECLOUDED	B IH K L AW D IH D
BEHELD	B IY HH EH L D
DEEMING	D IY M IH NG
BEHELC	B AH HH EH L K
EFFERVESCED	EH F AH R V EH S T
SLANTS	S L AE N T S
DEMURER	D IH M Y UH R ER
ABASHLESS	AH B AE SH L AH S
EMPERY	EH M P AH R IY
GOADS	G OW D Z
DOON	D UW AO N
UNNUMBERED	AH N AH M B ER D
JUSTOUR	JH AH S T AH R
DREARIER	D R IH ER IY ER
WAFTS	W AA F T S
UNWHOLE	AH N HH OW L
KNOCKER	N AA K ER
THEREAT	TH IY R IY T
ABSENTLY	AE B S AH N T L IY
PARASOL	P AE R AH S AO L
TABERNACLES	T AE B ER N AE K AH L Z
LADYS	L EY D IY Z
REDOUBTABLEST	R IY D AW T AH B AH L AH S T
DEADPUT	D EH D P UH T
DEPORTMENTS	D IY P OW R T M AH N T S
RESURGAM	R AH S AH R G AH M
BUCCANEERING	B AH K EY N AH R AH NG
DREST	D R EH S T
CORNICE	K AO R N AY S
DARKNESSES	D AA R K N AH S IH Z
ABJURED	AE B Y AH R D
GIBBETS	JH IH B AH T S
UNTIES	AH N T AY Z
VIAND	V AY AH N D
WANTONED	W AO N T AH N D
POMPS	P AA M P S
INSPIRITING	IH N S P IH R AH T IH NG
FOREIGNHOOD	F AO R AH N HH UH D
IGNOMINYS	IH G N AA M AH N AH Z
TELEGRAPHIC	T EH L AH G R AE F IH K
ANODYNES	AE N AH D AY N Z
SHOULDNT	SH OW L D N T
EFFULGENCIES	EH F UH L JH EH N S AY Z
INCONCEIVABLY	IH N K AH N S IY V AH B L IY
PLEADER	P L IY D ER
PINNACE	P IH N AH S
SCEPTIC	S K EH P T IH K
BAREHEAD	B EH R HH EH D
UNSUSTAINED	AH N S AH S T EY N D
UPHOLSTERER	AH P HH OW L S T ER ER
ADMIRABLER	AE D M AH R AH B AH L ER
SOLIDITIES	S AH L IH D AH T IY Z
JOVE	JH OW V
DEBONNAIRE	D AH B AA N AH AH R
SPHERIC	S F IH ER IH K
CONTRIVES	K AH N T R AY V Z
EVANESCE	EH V AH N EH S
INFESTING	IH N F EH S T IH NG
AMPLER	AE M P AH L ER
INFINITENESS	IH N F AH N AH T N AH S
FLAGONS	F L AE G AO N Z
ISNT	IH Z N T
HESPERIAN	HH EH S IY R IY AH N
CLOUDIER	K L AW D IY ER
REPUGNANTLY	R IH P AH G N AH N T L IY
DISCLOSER	D IH S K L OW Z ER
MILLINERY	M IH L AH N EH R IY
MILLINERS	M IH L AY N ER Z
THREESCORE	TH R IY S K OW R
TYRIAN	T AY R IY AH N
UNROLLED	AH N R OW L D
ALIGHTING	AH L AY T IH NG
INTERSPERSION	IH N T ER S P ER ZH AH N
PHILOLOGY	F AH L AA L AH JH IY
OPPOSITELY	AA P AH Z AH T L IY
ROADNOT	R OW D N AH T
PLEASANTER	P L EH Z AH N T ER
FIRMAMENT	F AH R M AH M AH N T
VIVAMUS	V IH V AH M AH S
CHRYSOPRASE	K R IH S AH P R EY Z
CHIVALRIES	SH IH V AH L R IY Z
BRINDLED	B R IH N D AH L D
BROOCHES	B R UW CH AH Z
EXPIATION	EH K S P IY EY SH AH N
RASHNESS	R AE SH N AH S
FLOORLESS	F L OW R L AH S
SHRIVEN	SH R AY V AH N
HENCEFORWARD	HH EH N S AH F AO R W AH R D
IMPERTINENCE	IH M P ER T AH N AH N S
DEGREELESS	D IH G R IY L AH S
LIVELONG	L IH V L AO NG
BARTSIA	B AA R T S IY AH
SUBLIMER	S AH B L AY M ER
TENDEREST	T EH N D ER AH S T
TASSELS	T AE S AH L Z
ENTRANCING	EH N T R AH N S IH NG
WHIPPOORWILL	W IH P UH R W IH L
UNGRASPED	AH N G R AE S P T
SPICIEST	S P AY S IY AH S T
WITHES	W IH TH S
BEGGARY	B EH G EH R IY
CRAPE	K R EY P
ANTIQUARY	AE N T IY K EH R IY
DONT	D AA N T
VELLUM	V EH L AH M
BURROWED	B ER OW D
THOSOEVER	TH AH S OW AH V AH R
INCORPOREAL	IH N K AO R P OW R IY AH L
SHOAL	SH OW L
TALISMANIC	T AE L AH S M AE N IH K
GURGLED	G ER G AH L D
ENTREATED	EH N T R IY T IH D
FOREVERMORE	F AO R AH V AH R M AH R
OVERBOLD	OW V ER B OW L D
DOGES	D AO G Z
PARD	P AA R D
LAPWINGS	L AE P W IH NG Z
DOWNIEST	D AW N IY AH S T
MINUTEST	M IH N AH T AH S T
VITALIZES	V AY T AH L AY Z IH Z
YIELDETH	Y IY L D IH TH
LEAGUELESS	L IY G L AH S
ANVILS	AE N V AH L Z
RUDDIER	R AH D IY ER
MUNIFICENCE	M Y UW N AH F IH S AH N S
WASNT	W AA Z N T
FLITTED	F L IH T IH D
SURMISING	S ER M AY Z IH NG
STEMLESS	S T EH M L AH S
PRECISER	P R IH S AY S ER
UNBARED	AH N B EH R D
ARKS	AA R K S
QUOTH	K W OW TH
AMITIES	AE M AH T IY Z
GOLIAH	G OW L AY AH
TANTAMOURIT	T AE N T AE M AH R AH T
BUSTLED	B AH S AH L D
LAPLANDS	L AE P L AE N D Z
FLAMBEAU	F L AE M B IY UW
SPACIOUSLY	S P EY SH AH S L IY
ARCHERS	AA R CH ER Z
BLENT	B L EH N T
HARRED	HH AA R D
VERDIET	V AH R D IY T
FESTAL	F EH S T AH L
FOOLISHER	F UW L IH SH ER
TAMBOURIN	T AE M B AH R AH N
IMPREGNABILITY	IH M P R EH G N AH B IH L AH T EH
MADONNAS	M AH D AA N AH Z
FATHOMING	F AE DH AH M IH NG
FRESHETS	F R EH SH AH T S
REWALKS	R IY W AO K S
TEMPESTS	T EH M P AH S T S
SERENER	S AH R IY N ER
VIVIDER	V IH V AH D ER
PYRITES	P AH R AY T S
WEVE	W IY V
STUBBLES	S T AH B AH L Z
HIE	HH AY
EXPOSITOR	IH K S P AA Z AH T ER
WHETTING	W EH T IH NG
CLEAVING	K L IY V IH NG
BETHLEEM	B IH TH L IY M
DOUBLET	D AW B L AH T
MANSE	M AE N S
LOVELINESS	L AH V L IY N AH S
DISENCHANTS	D IH S EH N CH AE N T S
DECOYING	D IY K OY IH NG
ATTARS	AE T AH R Z
DESPATCH	D IH S P AE CH
UNACKNOWLEDGED	AH N AE K N AA L IH JH D
DEBAR	D IY B AA R
OPPED	AA P T
THEATRICALS	TH IY AE T R IH K AH L Z
WIFES	W AY F S
VITALIZE	V AY T AH L AY Z
EFFLORESCENCE	EH F L AH R EH S AH N S
KNEELED	N IY L D
BELSHAZZARS	B IH L SH AE Z AH R Z
KITCHEND	K IH CH AH N D
ORIENTS	OW R IY EH N T S
DUMBLY	D AH M L IY
EFFACELESS	IH F EY S L AH S
WHOLL	W AO L
ENCHANTMENTS	EH N CH AE N T M AH N T S
SETDED	S EH T D AH D
POSSESSETH	P AH Z EH S IH TH
SAUNTERING	S AO N T IY R AH NG
POLTROON	P OW L T R UW N
INSTANTS	IH N S T AH N T S
SMOTE	S M OW T
PENINSULAS	P AH N IH N S AH L AH Z
WHOS	HH UW Z
DAINTIER	D EY N T IY ER
BEAUTYS	B Y UW T IY Z
WHOD	W AA D
ILLUMINES	IH L UW M AH N Z
SLIPT	S L IH P T
CATOS	K AE T AA S
IGNIS	IH G N AH S
DUNGEONED	D AH N JH AH N D
DOMINIS	D AA M AH N IY Z
LOVEST	L AH V AH S T
GAMBOGE	G AE M B OW JH
DOMINIE	D AA M AH N IY
STIPULUS	S T IH P Y AH L AH S
SOMBRE	S AA M B ER
THERES	DH EH R Z
CONCERNLESS	K AH N S ER N L AH S
GAMUTS	G AE M AH T S
WIFEHOOD	W AY F HH UH D
TIMBRELS	T IH M B R AH L Z
PALSIED	P AO L Z IY D
SATYRS	S AE T AH R Z
ASSUAGES	AH S W EY JH IH Z
CONSTANCYS	K AA N S T AH N S IY Z
CITADELS	S IH T AH D AH L Z
SAGACIOUS	S EY JH AH S IY AH S
CEREMONIOUS	S EH R AH M OW N IY AH S
FUSTIAN	F AH S AH N
ITALICIZED	AY T AE L AH S AY Z D
SHIVERERS	SH IH V ER ER Z
DROWSIEST	D R AW Z IY AH S T
LATITUDELESS	L AE T AH T UW D L AH S
WINCES	W IH N S IH Z
ABSTEMIOUS	AE B S T IY M IY AH S
WAKENS	W EY K AH N Z
POMPEII	P AA M P IY IY
WISHFULNESS	W IH SH F AH L N AH S
STATESMANS	S T EY T S M AE N Z
DOMINIONS	D AH M IH N Y AH N Z
UNWEARIED	AH N W IH R IY D
SOPHISTRIES	S AH F IH S T R AY Z
BURDOCK	B AH R D AH K
GAMBRELS	G AE M B R AH L Z
THEWS	TH UW Z
ALMANACS	AO L M AH N AE K S
FAGOT	F AE G AH T
EER	IY AH R
EEN	IY AH N
GRANDSIRES	G R AE N D S AY ER Z
BUCKETWERE	B AH K EH T W AH R
REFRACTED	R IH F R AE K T IH D
CANST	K AE N S T
ALIMENT	AH L AY M AH N T
UNSUBSTANTIAL	AH N S AH B S T AE N CH AH L
METRES	M IY T ER Z
ECLAT	EY K L AA
PLAYETH	P L EY IH TH
FATHERD	F AE T HH ER D
VIVIMUS	V IH V AH M AH S
STAMENS	S T EY M AH N Z
EPICURES	EH P IH K Y UH R Z
BRITDE	B R IH T D
SYNODS	S IH N AH D Z
PELF	P EH L F
DURABLER	D UH R AH B AH L ER
LISPED	L IH S P T
UNJADED	AH N JH EY D IH D
DESCRIED	D IH S R AY D
OER	OW AH R
REDEEMERS	R IY D IY M ER Z
VITALS	V AY T AH L Z
BISECTING	B AY S EH K T IH NG
WOULDNT	W OW L D N T
MESMERIC	M IY Z M IH ER IH K
GIANTURE	JH AY AH N CH ER
SEPULTURE	S AH P UH L T Y AH R
FRUITLESSER	F R UW T L AH S ER
HEEDLESS	HH IY D L AH S
ENGINERY	EH N JH AH N AH R IY
ANANIAS	AH N EY N Y AH Z
DIAMETERS	D AY AE M AH T ER Z
SUPPLICATING	S AH P L AH K EY T IH NG
LEARNETH	L ER N IH TH
TINGLES	T IH NG G AH L Z
UNINTENDING	AH N IH N T EH N D IH NG
ABBEYS	AE B IY Z
SPECIFICAL	S P IH S IH F IH K AH L
EXTEMPORANEOUS	IH K S T EH M P AH R EY N IY AH S
IMPUDENT	IH M P Y AH D AH N T
WAKELESSNESS	W EY K L AH S N AH S
AZOF	AE Z AH F
GRANDAMES	G R AE N D EY M Z
STILLEST	S T IH L AH S T
ECSTASIES	EH K S T AH S IY Z
STARKEST	S T AA R K AH S T
IMMURED	IH M Y AH R D
RINGLET	R IH NG L AH T
REPRIEVING	R IH P R IY V IH NG
THOTHE	TH OW DH
PERFECTNESS	P ER F AH K T N AH S
QUAINTER	K W EY N T ER
DAZZLINGLY	D AE Z AH L IH NG L IY
REVEILLE	R AH V EY L
SHES	SH IY Z
CURRICLE	K AH R AH K AH L
GRAVITATIONS	G R AE V AH T EY SH AH N Z
SCINTILLATES	S IH N T AH L AH T S
ORGANDY	AO R G AH N D IY
CURRER	K ER ER
NECTARS	N EH K T ER Z
VITALLESS	V AY T AH L AH S
THEYLL	TH EY L
VITALLEST	V AY T AH L AH S T
RESITUATED	R IY S IH CH AH W EY T IH D
TARE	T AE R
FRUCTIFIED	F R AH K T AH F AY D
TRANSMUTED	T R AE N S M Y UW T IH D
JOCOSER	JH OW K OW S ER
KIRTLE	K AH R T AH L
GIMLETS	JH IH M L AH T S
PHAETON	F IY T AH N
THREADLESS	TH R EH D L AH S
VICI	V IH S IY
SOLEMNER	S AA L AH M ER
DEMANDETH	D IH M AE N D IH TH
FURZE	F AH R Z
SIXPENCE	S IH K S AH N S
LOWLIEST	L OW L IY AH S T
FLESHLESS	F L EH SH L AH S
SURCINGLES	S AH R S AH N G AH L Z
STATURES	S T AE CH ER Z
NOTABILITY	N OW T AH B IH L AH T EH
OCLOCK	AA K L AH K
COUNTERPASS	K AW N T ER P AE S
SCARLETS	S K AA R L AH T S
SEPTEMBERS	S EH P T EH M B ER Z
GLEES	G L IY Z
STATURED	S T AE CH ER D
COQUETTISH	K OW K EH T IH SH
PINIONS	P IH N Y AH N Z
PHYSIOGNOMY	F IH Z IY AA G N AH M IY
SUBLIMELY	S AH B L AY M L IY
MOTTLES	M AA T AH L Z
TURBANED	T ER B AH N D
KINSMEN	K IH N Z M EH N
HAVENT	HH EY V AH N T
CHRYSOPHRASE	K R IH S AH F R EY Z
ENCLOSES	EH N K L OW Z IH Z
SACKCLOTH	S AE K L AO TH
THRONGING	TH R AO NG IH NG
PERIPHRASIS	P AH R IH F R AH S AH S
LANGUOR	L AE N G W AH R
BENUMBING	B IH N AH M IH NG
WHIFFIETREE	W IH F IY T R IY
UNSHARED	AH N SH EH R D
SEPULCHRE	S EH P AH L K ER
WEARIEST	W IH R IY AH S T
CORDILLERA	K AO R D IH L IH R AH
EDENLL	EH D AH N L
ACCOSTAL	AH K AO S T AH L
CUBITS	K Y UW B AH T S
INDUSTRIOUSNESS	IH N D AH S T R IY AH S N AH S
FISHERMANS	F IH SH ER M AE N Z
BODK	B AA D K
PERPLEXEDLY	P ER P L EH K S AH D L IY
ASKETH	AE S K IH TH
ARCHNESS	AA R CH N AH S
DROPT	D R AA P T
METRE	M IY T ER
REDBREAST	R EH D B R EH S T
REMITS	R IH M IH T S
ASPHODEL	AE S AH D AH L
PLUMPER	P L AH M P ER
TYPIC	T IH P IH K
VAUNT	V AO N T
CLIME	K L AY M
HASPS	HH AE S P S
THATS	DH AE T S
CONTENTMENTS	K AH N T EH N T M AH N T S
ALTHO	AE L TH OW
DECLIVITY	D IH K L IH V AH T IY
CONJECTURING	K AH N JH EH K CH ER IH NG
RIPENESS	R AY P N AH S
COMPREHENDETH	K AA M P R IH HH EH N D IH TH
ETERNITYS	IH T ER N AH T IY Z
YCLEPT	Y K L EH P T
CRAG	K R AE G
DEBAUCHEE	D AH B AO CH IY
CAVILER	K EY V AH L AH R
COMBINEDLY	K AH M B AY N AH D L IY
HUELESS	HH Y UW L AH S
GOLDWHO	G OW L D W HH OW
LOOKETH	L UH K IH TH
RESOWN	R IY S OW N
MEED	M IY D
PERPENDICULARS	P ER P AH N D IH K Y AH L ER Z
GOALLESS	G OW L AH S
DIDNT	D IH D N T
CHERUBIM	CH EH R AH B IH M
THERMOPYLAE	TH AH R M AA P AH L IY
INTUITIONS	IH N T UH IH SH AH N Z
UNAPPROACHED	AH N AH P R OW CH T
ANTEDATE	AE N T IH D AH T
PROCURES	P R OW K Y UH R Z
NEARNESS	N IH ER N AH S
TODDLED	T AA D AH L D
GENEVAS	JH EH N AH V AH Z
RESOLUTER	R EH Z AH L UW T ER
MANACLES	M AE N AH K AH L Z
PALER	P EY L ER
DNIEPER	D N IY P AH R
ACHASE	AH CH EY S
RAIMENT	R EY M AH N T
WRENS	R EH N Z
CHASTENS	CH AE S T AH N Z
POLITEAND	P AA L AH T IY N D
BOUNDLESSNESS	B AW N D L AH S N AH S
EVENTIDE	IY V AH N T AY D
IMMENSITY	IH M EH N S AH T IY
OVERSETS	OW V ER S EH T S
WALTZED	W AO L T S T
SLUMBERETH	S L AH M B ER IH TH
SIGHTLESS	S AY T L AH S
SEDULOUS	S EH JH AH L AH S
THYSELF	DH AY S EH L F
ADDERS	AE D ER Z
OBEISANCE	OW B EY S AH N S
WHEREON	W EH ER AO N
LETTRES	L EH T AH R Z
ALWAY	AE L W EY IY
PLAYFELLOW	P L EY F EH L OW
PERFECTEST	P ER F AH K T AH S T
MODESTIES	M AA D AH S T IY Z
BANQUETTINGS	B AE NG K W AH T IH NG Z
ABSTEMIOUSNESS	AE B S T IY M IY AW Z N AH S
EXISTENCES	EH G Z IH S T AH N S IH Z
PREVISION	P R IY V IH ZH AH N
CAMBRIC	K AE M B R AH K
INTERWORN	IH N T ER W OW R N
SOEER	S OW IH R
KINSMANLESS	K IH N Z M AE N L AH S
DWELLETH	D W EH L IH TH
NAZARENE	N AE Z AH R IY N
ABLATIVE	AH B L EY T IH V
FOOTMEN	F UH T M EH N
QUIVERED	K W IH V ER D
VERILY	V EH R IY L IY
IMPANELLED	IH M P AE N AH L D
DOWERLESS	D AW ER L AH S
TARRYING	T AE R IY IH NG
ENCAMPING	EH N K AE M P IH NG
SOLEMNIZES	S AA L AH M AY Z IH Z
SPUMED	S P Y UW M D
SCIMITAR	S IH M AH T ER
PALMLEAF	P AA M L IY F
ESTEEMING	IH S T IY M IH NG
ETHIOP	EH TH IY AH P
VANDYKES	V AE N D AY K S
TULLE	T UW L
BOANERGES	B OW N AH R JH AH Z
TONGUELESS	T AH NG L AH S
WORKMANSHIPS	W ER K M AE N SH IH P S
ILLOCALITY	IH L OW K AE L AH T IY
SOLDERED	S AA D ER D
DESIRELESS	D IH Z AY ER L AH S
WRECKETH	R EH K IH TH
DISEMBODIES	D IH S IH M B AA D IY Z
MOIETY	M OW AY AH T IY
DEMIJOHN	D AH M IH JH AH N
CHINTZ	CH IH N T S
FAMISHING	F EY M IH SH IH NG
BAPTIZES	B AE P T IH Z IH Z
BESEEMETH	B IH S IY M IH TH
SOUNDLESS	S AW N D L AH S
AUGHT	AO T
PRUDENTER	P R UW D AH N T ER
HILLOCKS	HH IH L AH K S
OMNIFOLD	AA M N AH F OW L D
CANTICLE	K AE N T IH K AH L
UNSCRUTINIZED	AH N S R UW T AH N AY Z D
GAMBOL	G AE M B AH L
FAINTS	F EY N T S
BEGGARED	B EH G ER D
CONSTERNATIONS	K AA N S T ER N EY SH AH N Z
FASHIONLESS	F AE SH AH N L AH S
WAKED	W EY K T
TERRIBLER	T EH R AH B AH L ER
BISCAYAN	B AY S EY AH N
SILENTER	S AY L AH N T ER
CLOVE	K L OW V
OVERTAKELESSNESS	OW V ER T EY K L AH S N AH S
APRILS	EY P R IH L Z
OERSPENT	AH R S AH N T
MORTISED	M AO R T IY Z D
AWES	AO Z
COMEST	K AH M AH S T
PIZARROS	P AH Z AE R AH Z
TINCTURED	T IH NG K CH ER D
ACHIRRUP	AH CH AH R AH P
DEATHLESS	D EH TH L AH S
INSTIL	IH N S T IH L
CIRCUMSCRIBES	S ER K AH M S K R AY B Z
COULDST	K OW AH L D S T
NOTELESSLY	N OW T L AH S L IY
ORGOT	AO R G AH T
SERAPH	S EH R AH F
CHANCEL	CH AE N S AH L
CHANCED	CH AE N S T
ILLUMINE	IH L UW M AH N
UNPLAUSIBLE	AH N P L AO Z AH B AH L
MANACLE	M AE N AH K AH L
ENAMELLED	IH N AE M AH L D
BRAYED	B R EY D
UNDIVINE	AH N D AH V AY N
DISTINCTER	D IH S T IH NG K T ER
ELFS	EH L F S
LUSTRAL	L AH S T ER AH L
FLATTENS	F L AE T AH N Z
UNANOINTED	AH N AH N OY N T AH D
WHIMPERED	W IH M P ER D
PUZZLEST	P AH Z AH L AH S T
ABTOAD	AE B T OW D
BISECT	B AY S EH K T
NUTRIMENT	N AH T R IY M AH N T
SAUNTERED	S AO N T IY R D
TOBYS	T AA B AH Z
HEMISPHERES	HH EH M AH S F IH ER Z
MANYS	M EH N IY Z
SHD	EH S EY CH D
MINISTERED	M IH N AH S T ER D
SHO	SH OW
ODIOUSER	OW D IY AH S ER
ALLURES	AH L UH R Z
RESPITES	R EH S P AH T S
FINITENESS	F AY N AY T N AH S
DESPOILED	D IY S P OY L D
GLORYS	G L OW R IY Z
COVETING	K AH V AH T IH NG
FTEDS	F T EH D Z
IBYE	IH B AY
YOULL	Y OW L
ANCIENTER	EY N SH AH N T ER
GETHSEMANE	JH EH TH S AH M EY N
DATELESS	D EY T L AH S
JOGGLE	JH AA G AH L
MARROWS	M AE R OW Z
ASLANT	AH S L AE N T
FERVORS	F ER V ER Z
LEASTA	L IY S T AH
PERFIDIOUS	P ER F IH D IY AH S
UNTUMBLED	AH N T AH M B AH L D
KINSMANSHIP	K IH N Z M AE N SH IH P
VIANDS	V AY AH N D Z
BEGUILES	B IH G AY L Z
SUMPTUOUSNESS	S AH M P CH AH W AH S N AH S
CASTANET	K AE S T AH N EH T
VERMINS	V AH R M AH N Z
FEEBLEST	F IY B AH L AH S T
VENI	V EH N IY
LITTLEMINOR	L IH T AH L M AY N ER
LASSITUDES	L AE S AH T UW D Z
SANCTIFYING	S AE NG K T AH F AY IH NG
BUMBLEBEE	B AH M B AH L B IY
CHIEFER	CH IY F ER
COLUMNAR	K AA L AH M ER
SEPULCHRAL	S EH P AH L K ER AH L
NOBLENESS	N OW B AH L N AH S
BEHOOVETH	B IH HH UW V IH TH
UNCERTIFIED	AH N S ER T AH F AY D
ADDETH	AE D IH TH
HAREBELL	HH EH R B EH L
MAGNETIZE	M AE G N AH T AY Z
PROSY	P R OW Z IY
OBLIVIONS	AH B L IH V IY AH N Z
FINITY	F AY N AH T IY
WAKINGS	W EY K IH NG Z
DOUBLOONS	D AH B L UW N Z
VEXT	V EH K S T
VASTER	V AE S T ER
CLAMORS	K L AE M ER Z
FEBRUARYS	F EH B Y AH W EH R IY Z
DIEMANS	D AY M AE N Z
UNGAINED	AH N G EY N D
SURETIES	SH UH R T AY Z
TISNT	T IH Z N T
PRICKLED	P R IH K L EH D
CEREMENTS	S EH R AH M AH N T S
FIRMAMENTS	F AH R M AH M AH N T S
UNSOWN	AH N S OW N
CAUSEDIT	K AO S AH D AH T
ITSCAN	IH T S K AE N
UNFITTED	AH N F IH T IH D
BUILDED	B IH L D IH D
GRANDMAMA	G R AE N D M AH M AH
AFFRIGHT	AE F R AY T
CONDESCENDED	K AA N D IH S EH N D IH D
APOSTASY	AH P AA S T AH Z IY
RAMBLES	R AE M B AH L Z
VIDI	V IH D IY
REPREHEND	R IH P R AH HH EH N D
NICODEMUS	N AH K AA D AH M AH S
DIMITIES	D AY M AH T IY Z
CONTEMPTS	K AH N T EH M P T S
PRACTISE	P R AE K T IH S
FOUNDETH	F AW N D IH TH
LIBERTYS	L IH B ER T IY Z
MOMENTLY	M OW M AH N T L IY
REVERY	R EH V AH R IY
PLUSHES	P L AH SH IH Z
INTERVIEWHAD	IH N T AH R V IY W HH AH D
ENEMYS	EH N AH M IY Z
CHAOSES	K EY AA S IH Z
HEET	HH IY T
RANSOMED	R AE N S AH M D
BROADCLOTH	B R AO D K L AO TH
PARCHING	P AA R CH IH NG
LIKER	L AY K ER
MONTCALM	M AA N T AH M
STINTLESS	S T IH N T L AH S
STRAIGHTWAY	S T R EY T W EY
TWITTER	T W IH T ER
SINEWS	S IH N Y UW Z
SERAPHS	S EH R AH F S
ANTIQUEST	AE N T AY K W EH S T
UNATTEMPTED	AH N AH T EH M P T IH D
SCATTERS	S K AE T ER Z
UTTEREST	AH T ER AH S T
STIRLESS	S T ER L AH S
JVTYSELF	JH V T AH S EH L F
COSTUMELESS	K AA S T UW M L AH S
SCRUTABLE	S K R UW T AH B AH L
BARABBAS	B AH R AE B AH Z
HURLS	HH ER L Z
PERUKE	P AH R Y UW K IY
PULPY	P AH L P IY
HESPERIDES	HH EH S AH R AY D Z
GENTIANS	JH EH N CH AH N Z
BENUMBED	B IH N AH M D
INDURATED	IH N D UH R EY T IH D
SUBLIMEST	S AH B L AY M AH S T
TRANSITIVE	T R AE N Z AH T IH V
OERLOOKING	AH R L AH K AH NG
BOGGY	B AO G IY
REDUCELESS	R IH D UW S L AH S
FLEETER	F L IY T ER
DOESNT	D OW AH Z N T
THEYD	TH EY D
COULDNT	K OW AH L D N T
QUAFFING	K W AA F AH NG
UNWINDS	AH N W IH N D Z
SERAPHIC	S EH R AH F AH K
VASTEST	V AE S T AH S T
SPORTSMANS	S P OW R T S M AE N Z
PREFERMENT	P R IH F ER M AH N T
OERTOOK	AH R T AH K
RELEGATES	R EH L AH G EY T S
PRECEPTOR	P R IY S EH P T ER
GLID	G L IH D
AFRONTED	AH F R AH N T IH D
GOSSIPPED	G AA S AH P T
TILLED	T IH L D
ULTIMATES	AH L T AH M AH T S
PELTETH	P EH L T IH TH
OPTIZAN	AA P T AY Z AH N
REDECKED	R IY D EH K T
PHOEBES	F OW AH B Z
BEREAVES	B IH R IY V Z
MINUTER	M IH N AH T ER
LITURGIES	L IH T ER JH IY Z
HABILIMENT	HH AH B IH L AH M AH N T
GLOBULES	G L AA B Y UW L Z
ABYSSS	AH B IH S
HUNGERED	HH AH NG G ER D
DIDST	D IH D S T
GULFING	G AH L F IH NG
IMPORTUNES	IH M P ER T UW N Z
UNRELUCTANTLY	AH N R IH L AH K T AH N T L IY
FARNESS	F AA R N AH S
PERDITION	P ER D AY SH AH N
IMPORTUNED	IH M P ER T UW N D
FATUUS	F AE T Y UW AH S
UNDRAINED	AH N D R EY N D
SPECTRES	S P EH K T ER Z
CASQUE	K AE S
SECUREST	S IH K Y UH R AH S T
SERAPHIM	S ER AA F IY M
SABACHTHANI	S AH B AE CH TH AH N IY
HONORLESS	AA N ER L AH S
MORNS	M AO R N Z
EDDIED	EH D IY D
DAPPERER	D AE P ER ER
RIPEST	R AY P AH S T
COQUETTE	K OW K EH T
SURPLICE	S AH R P L AH S
ENTREAT	EH N T R IY T
GRASPLESS	G R AE S P L AH S
THOURT	TH AW R T
EPIGEA	EH P IY JH IY EH
YESTERMORN	Y EH S T ER M AO R N
PENIEL	P EH N IY L
HALLELUJAHS	HH AA L EY L UW Y AA S
LABORETH	L EY B AO R IH TH
CLIPT	K L IH P T